############################ E ############################
#                    #             #                      #
#                    #             #                      #
#                                                         #
#                    #             #                      #
####   #########   #################                      #
#         #                    #                          #
#         #                    #                          #
#                                                         #
#         #                    #                          #
#         #                    #                          #
#         ###   #########   ####################       ####
#         #         #          #            #             #
#         #         #          #            #             #
#         #         #                       #             #
#         #         #          #            #             #
#         #         #          #            #             #
###############   ########  ####            #             #
#         #                    #            #             #
#         #                    #            #             #
#                              #            #             #
#         #                    #            #             #
#         #                                               #
##################### S ###################################